"aa" = (/turf/template_noop,/area/template_noop)
"ab" = (/turf/simulated/floor/plating/asteroid/basalt/lava_land_surface,/area/lavaland/surface/outdoors)
"ac" = (/turf/simulated/wall/mineral/plastitanium/nodiagonal,/area/ruin/powered/seedvault)
"ad" = (/obj/structure/closet/crate/hydroponics,/obj/structure/beebox,/obj/item/melee/flyswatter,/obj/item/honey_frame,/obj/item/honey_frame,/obj/item/honey_frame,/obj/item/queen_bee/bought,/obj/item/clothing/head/beekeeper_head,/obj/item/clothing/suit/beekeeper_suit,/turf/simulated/floor/mineral/titanium,/area/ruin/powered/seedvault)
"ae" = (/obj/machinery/light{dir = 1; in_use = 1},/obj/machinery/computer,/turf/simulated/floor/mineral/titanium,/area/ruin/powered/seedvault)
"af" = (/obj/structure/table/wood,/obj/item/lighter,/obj/item/lighter,/obj/item/storage/fancy/rollingpapers,/obj/item/storage/fancy/rollingpapers,/obj/item/storage/fancy/rollingpapers,/obj/item/storage/fancy/rollingpapers,/turf/simulated/floor/mineral/titanium,/area/ruin/powered/seedvault)
"ag" = (/obj/structure/table/wood,/obj/item/storage/box/disks_plantgene,/obj/machinery/light{dir = 1},/turf/simulated/floor/mineral/titanium,/area/ruin/powered/seedvault)
"ah" = (/obj/structure/table/wood,/obj/item/storage/box/disks_plantgene,/turf/simulated/floor/mineral/titanium,/area/ruin/powered/seedvault)
"ai" = (/obj/machinery/plantgenes/seedvault{pixel_y = 6},/obj/structure/table/wood,/turf/simulated/floor/mineral/titanium,/area/ruin/powered/seedvault)
"aj" = (/obj/structure/shuttle/engine/propulsion{dir = 4},/turf/simulated/floor/plating/asteroid/basalt/lava_land_surface,/area/lavaland/surface/outdoors)
"ak" = (/obj/structure/table/wood,/obj/machinery/smartfridge/disks{pixel_y = 2},/turf/simulated/floor/mineral/titanium,/area/ruin/powered/seedvault)
"al" = (/obj/structure/table/wood,/obj/machinery/chem_heater,/turf/simulated/floor/mineral/titanium,/area/ruin/powered/seedvault)
"am" = (/obj/machinery/light{dir = 1},/obj/structure/table/wood,/obj/machinery/recharger,/turf/simulated/floor/mineral/titanium,/area/ruin/powered/seedvault)
"an" = (/obj/machinery/autolathe/upgraded,/obj/structure/table/wood,/turf/simulated/floor/mineral/titanium,/area/ruin/powered/seedvault)
"ao" = (/obj/machinery/floodlight,/turf/simulated/floor/mineral/titanium,/area/ruin/powered/seedvault)
"ap" = (/obj/structure/closet/crate,/obj/effect/spawner/lootdrop/seed_vault,/obj/item/seeds/random/labelled,/obj/item/seeds/random/labelled,/obj/item/seeds/random/labelled,/obj/item/seeds/random/labelled,/obj/item/seeds/random,/turf/simulated/floor/mineral/titanium,/area/ruin/powered/seedvault)
"aq" = (/turf/simulated/floor/mineral/titanium,/area/ruin/powered/seedvault)
"ar" = (/obj/structure/closet/crate,/obj/effect/spawner/lootdrop/seed_vault,/obj/item/seeds/random/labelled,/obj/item/seeds/random/labelled,/obj/item/seeds/random,/turf/simulated/floor/mineral/titanium,/area/ruin/powered/seedvault)
"as" = (/obj/machinery/door/airlock/titanium,/turf/simulated/floor/mineral/titanium,/area/ruin/powered/seedvault)
"at" = (/obj/machinery/smartfridge,/turf/simulated/floor/mineral/titanium/blue,/area/ruin/powered/seedvault)
"au" = (/obj/structure/closet/crate/hydroponics,/obj/item/cultivator,/obj/item/cultivator,/obj/item/cultivator,/obj/item/cultivator,/obj/item/shovel/spade,/obj/item/shovel/spade,/obj/item/shovel/spade,/obj/item/shovel/spade,/obj/item/hatchet,/obj/item/hatchet,/obj/item/hatchet,/obj/item/hatchet,/turf/simulated/floor/mineral/titanium/blue,/area/ruin/powered/seedvault)
"av" = (/obj/machinery/hydroponics/constructable,/obj/machinery/light{dir = 1},/turf/simulated/floor/mineral/titanium/blue,/area/ruin/powered/seedvault)
"aw" = (/obj/machinery/hydroponics/constructable,/turf/simulated/floor/mineral/titanium/blue,/area/ruin/powered/seedvault)
"ax" = (/obj/item/hatchet,/obj/item/storage/bag/plants,/obj/item/reagent_containers/glass/bucket,/obj/structure/table/wood,/turf/simulated/floor/mineral/titanium/blue,/area/ruin/powered/seedvault)
"ay" = (/obj/structure/table/wood,/obj/item/storage/bag/plants,/obj/item/storage/bag/plants,/obj/item/storage/bag/plants,/obj/item/storage/bag/plants,/turf/simulated/floor/mineral/titanium/blue,/area/ruin/powered/seedvault)
"az" = (/obj/structure/table/wood,/obj/item/gun/energy/floragun,/obj/item/gun/energy/floragun,/obj/item/gun/energy/floragun,/obj/item/gun/energy/floragun,/obj/item/storage/box/disks_plantgene,/turf/simulated/floor/mineral/titanium/blue,/area/ruin/powered/seedvault)
"aA" = (/obj/machinery/light{dir = 4},/turf/simulated/floor/mineral/titanium,/area/ruin/powered/seedvault)
"aB" = (/obj/machinery/light{dir = 8},/turf/simulated/floor/mineral/titanium/blue,/area/ruin/powered/seedvault)
"aC" = (/obj/structure/sink{dir = 8; pixel_x = -12; pixel_y = 2},/turf/simulated/floor/mineral/titanium/blue,/area/ruin/powered/seedvault)
"aD" = (/obj/machinery/vending/hydronutrients,/turf/simulated/floor/mineral/titanium/blue,/area/ruin/powered/seedvault)
"aE" = (/obj/machinery/vending/hydroseeds,/turf/simulated/floor/mineral/titanium/blue,/area/ruin/powered/seedvault)
"aF" = (/obj/machinery/reagentgrinder{pixel_y = 5},/obj/structure/table/glass,/obj/item/reagent_containers/glass/beaker/bluespace,/obj/item/reagent_containers/glass/beaker/bluespace,/obj/item/reagent_containers/glass/beaker/bluespace,/obj/item/reagent_containers/glass/beaker/bluespace,/turf/simulated/floor/mineral/titanium/blue/airless,/area/ruin/powered/seedvault)
"aG" = (/obj/structure/sink{dir = 4; pixel_x = 11},/turf/simulated/floor/mineral/titanium,/area/ruin/powered/seedvault)
"aH" = (/obj/machinery/door/airlock/external{frequency = 1385; id_tag = "seed_vault_inner"; locked = 1},/obj/structure/fans/tiny,/turf/simulated/floor/mineral/titanium,/area/ruin/powered/seedvault)
"aI" = (/obj/machinery/embedded_controller/radio/airlock/access_controller{frequency = 1385; id_tag = "seed_vault"; pixel_y = 25; tag_exterior_door = "seed_vault_outer"; tag_interior_door = "seed_vault_inner"},/turf/simulated/floor/mineral/titanium,/area/ruin/powered/seedvault)
"aJ" = (/obj/machinery/door/airlock/external{frequency = 1385; id_tag = "seed_vault_outer"; locked = 1},/obj/structure/fans/tiny,/turf/simulated/floor/mineral/titanium,/area/ruin/powered/seedvault)
"aK" = (/obj/effect/mob_spawn/human/seed_vault,/turf/simulated/floor/mineral/titanium,/area/ruin/powered/seedvault)
"aL" = (/obj/effect/baseturf_helper/lava_land/surface,/turf/simulated/floor/mineral/titanium,/area/ruin/powered/seedvault)
"aM" = (/obj/machinery/access_button{command = "cycle_interior"; frequency = 1385; master_tag = "seed_vault"; name = "interior access button"; pixel_x = 25; pixel_y = -25; req_access_txt = null},/turf/simulated/floor/mineral/titanium,/area/ruin/powered/seedvault)
"aN" = (/obj/structure/fans/tiny,/obj/machinery/door/airlock/external{frequency = 1385; id_tag = "seed_vault_outer"; locked = 1},/turf/simulated/floor/mineral/titanium,/area/ruin/powered/seedvault)
"aO" = (/obj/structure/disposalpipe/trunk,/obj/machinery/disposal,/turf/simulated/floor/mineral/titanium/blue,/area/ruin/powered/seedvault)
"aP" = (/obj/machinery/seed_extractor,/turf/simulated/floor/mineral/titanium/blue,/area/ruin/powered/seedvault)
"aQ" = (/obj/machinery/biogenerator,/turf/simulated/floor/mineral/titanium/blue,/area/ruin/powered/seedvault)
"aR" = (/obj/machinery/chem_dispenser/mutagensaltpeter,/turf/simulated/floor/mineral/titanium/blue,/area/ruin/powered/seedvault)
"aS" = (/obj/structure/disposalpipe/segment,/turf/simulated/floor/mineral/titanium,/area/ruin/powered/seedvault)
"aT" = (/obj/machinery/access_button{command = "cycle_exterior"; frequency = 1385; master_tag = "seed_vault"; name = "exterior access button"; pixel_x = -25; pixel_y = -25; req_access_txt = null},/turf/simulated/floor/plating/asteroid/basalt/lava_land_surface,/area/lavaland/surface/outdoors)
"aU" = (/obj/machinery/light,/turf/simulated/floor/mineral/titanium,/area/ruin/powered/seedvault)
"aV" = (/obj/machinery/vending/sovietsoda,/turf/simulated/floor/mineral/titanium/blue,/area/ruin/powered/seedvault)
"aW" = (/obj/structure/closet/crate/hydroponics,/obj/item/clothing/under/rank/hydroponics,/obj/item/clothing/under/rank/hydroponics,/obj/item/clothing/under/rank/hydroponics,/obj/item/clothing/under/rank/hydroponics,/turf/simulated/floor/mineral/titanium/blue,/area/ruin/powered/seedvault)
"aX" = (/obj/machinery/hydroponics/constructable,/obj/machinery/light,/turf/simulated/floor/mineral/titanium/blue,/area/ruin/powered/seedvault)
"aY" = (/obj/structure/disposalpipe/segment{dir = 1; icon_state = "pipe-c"},/turf/simulated/floor/mineral/titanium,/area/ruin/powered/seedvault)
"aZ" = (/obj/structure/disposalpipe/segment{dir = 4},/obj/machinery/hydroponics/constructable,/turf/simulated/floor/mineral/titanium/blue/airless,/area/ruin/powered/seedvault)
"ba" = (/obj/machinery/hydroponics/constructable,/obj/structure/disposalpipe/segment{dir = 4},/turf/simulated/floor/mineral/titanium/blue,/area/ruin/powered/seedvault)
"bb" = (/obj/machinery/chem_master/condimaster,/obj/structure/disposalpipe/segment{dir = 4},/turf/simulated/floor/mineral/titanium/blue,/area/ruin/powered/seedvault)
"bc" = (/obj/machinery/hydroponics/constructable,/obj/machinery/light,/obj/structure/disposalpipe/segment{dir = 4},/turf/simulated/floor/mineral/titanium/blue,/area/ruin/powered/seedvault)
"bd" = (/obj/structure/table/wood,/obj/item/reagent_containers/glass/bucket,/obj/item/reagent_containers/glass/bucket,/obj/item/reagent_containers/glass/bucket,/obj/item/reagent_containers/glass/bucket,/obj/structure/disposalpipe/segment{dir = 4},/turf/simulated/floor/mineral/titanium/blue,/area/ruin/powered/seedvault)
"be" = (/obj/item/storage/toolbox/syndicate,/obj/structure/table/wood,/obj/structure/disposalpipe/segment{dir = 4},/turf/simulated/floor/mineral/titanium/blue,/area/ruin/powered/seedvault)
"bf" = (/obj/structure/disposalpipe/segment{dir = 4},/turf/simulated/wall/mineral/plastitanium/nodiagonal,/area/ruin/powered/seedvault)
"bg" = (/obj/structure/disposalpipe/trunk{dir = 8},/turf/simulated/wall/mineral/plastitanium/nodiagonal,/area/ruin/powered/seedvault)

(1,1,1) = {"
aaaaaaaaaaaaaaaaaaaaaaaaaaaaaaaaaaaaaaaa
aaaaaaaaaaaaaaaaaaaaaaaaaaaaaaaaaaaaaaaa
acacacacacacacacacacacacacacacaaaaaaaaaa
acadaeacacafagahaiakalamanacacajaaaaaaaa
acadaoacapaqaqaqaqaqaqaqaqaracacaaaaaaaa
acaqaqacacacacasacacacacacacacajaaababaa
acaqaqacatauavaqawawaxavayazacacaaababaa
acaqaAacaBaqaqaqaqaqaqaqaqaAacajaaababaa
acaqaqacaCaqawaDataEaFaqaqaGacacacababab
acaqaqasaqaqaqaqaqaqaqaqawaqaHaIaJababab
acaKaqasaqaqaqaqaqaLaqaqawaMaHaqaNaTabab
acaKaqacaCaqawaOaPaQaRaqaqaGacacacababab
acaKaAacaBaqaqaSaqaqaqaqaqaAacajaaababab
acaKaUacaVaWaXaYaZbabbbcbdbebfbgaaaaaaaa
acacacacacacacacacacacacacacacajaaaaaaaa
aaaaaaaaaaaaaaaaaaaaaaaaaaaaaaaaaaaaaaaa
aaaaaaaaaaaaaaaaaaaaaaaaaaaaaaaaaaaaaaaa
aaaaaaaaaaaaaaaaaaaaaaaaaaaaaaaaaaaaaaaa
aaaaaaaaaaaaaaaaaaaaaaaaaaaaaaaaaaaaaaaa
aaaaaaaaaaaaaaaaaaaaaaaaaaaaaaaaaaaaaaaa
"}
