"aa" = (/turf/template_noop,/area/template_noop)
"ab" = (/turf/simulated/wall/mineral/titanium/overspace,/area/shuttle/freegolem)
"ac" = (/obj/structure/fans/tiny,/obj/machinery/door/airlock/shuttle,/turf/simulated/floor/plating,/area/shuttle/freegolem)
"ad" = (/obj/structure/closet/crate/golemgear,/turf/simulated/floor/plating,/area/shuttle/freegolem)
"ae" = (/obj/item/storage/toolbox/mechanical,/obj/item/reagent_containers/spray/cleaner,/turf/simulated/floor/plating,/area/shuttle/freegolem)
"af" = (/turf/simulated/floor/plating,/area/shuttle/freegolem)
"ag" = (/obj/structure/reagent_dispensers/watertank/high,/turf/simulated/floor/plating,/area/shuttle/freegolem)
"ah" = (/obj/structure/shuttle/engine/heater{icon_state = "heater"; dir = 4},/obj/structure/window/reinforced{dir = 8},/turf/simulated/floor/plating,/area/shuttle/freegolem)
"ai" = (/obj/structure/shuttle/engine/propulsion{dir = 4; icon_state = "burst_l"},/turf/simulated/floor/plating,/area/shuttle/freegolem)
"aj" = (/obj/machinery/light/small,/turf/simulated/floor/plating,/area/shuttle/freegolem)
"ak" = (/obj/structure/reagent_dispensers/watertank,/turf/simulated/floor/plating,/area/shuttle/freegolem)
"al" = (/obj/machinery/vending/hydronutrients,/turf/simulated/floor/mineral/titanium/purple,/area/shuttle/freegolem)
"am" = (/obj/machinery/vending/hydroseeds,/turf/simulated/floor/mineral/titanium/purple,/area/shuttle/freegolem)
"an" = (/obj/machinery/light{dir = 1; on = 1},/turf/simulated/floor/mineral/titanium/purple,/area/shuttle/freegolem)
"ao" = (/turf/simulated/floor/mineral/titanium/purple,/area/shuttle/freegolem)
"ap" = (/obj/machinery/mineral/equipment_vendor/golem,/turf/simulated/floor/mineral/titanium/purple,/area/shuttle/freegolem)
"aq" = (/turf/simulated/wall/mineral/titanium/nodiagonal,/area/shuttle/freegolem)
"ar" = (/obj/structure/computerframe,/turf/simulated/floor/mineral/titanium/purple,/area/shuttle/freegolem)
"as" = (/obj/effect/mob_spawn/human/golem/adamantine,/turf/simulated/floor/mineral/titanium/purple,/area/shuttle/freegolem)
"at" = (/obj/machinery/light{dir = 8},/turf/simulated/floor/mineral/titanium/purple,/area/shuttle/freegolem)
"au" = (/obj/machinery/door/airlock/shuttle,/obj/structure/fans/tiny,/turf/simulated/shuttle/floor{icon_state = "floor5"},/area/shuttle/freegolem)
"av" = (/obj/machinery/computer/camera_advanced/shuttle_docker/golem_ship,/turf/simulated/floor/mineral/titanium/purple,/area/shuttle/freegolem)
"aw" = (/obj/machinery/door/airlock/shuttle,/turf/simulated/shuttle/floor{icon_state = "floor5"},/area/shuttle/freegolem)
"ax" = (/obj/structure/table/wood,/obj/item/resonator,/turf/simulated/floor/mineral/titanium/purple,/area/shuttle/freegolem)
"ay" = (/obj/structure/table/wood,/turf/simulated/floor/mineral/titanium/purple,/area/shuttle/freegolem)
"az" = (/obj/machinery/mineral/ore_redemption/golem,/turf/simulated/floor/mineral/titanium/purple,/area/shuttle/freegolem)
"aA" = (/turf/simulated/floor/plating/asteroid/basalt/lava_land_surface,/area/ruin/powered/golem_ship)
"aB" = (/obj/structure/window/full/shuttle{icon_state = "16"},/obj/structure/grille,/turf/simulated/floor/plating,/area/shuttle/freegolem)
"aD" = (/obj/structure/chair/comfy/purp{dir = 8; icon_state = "comfychair"},/turf/simulated/floor/mineral/titanium/purple,/area/shuttle/freegolem)
"aE" = (/obj/structure/window/reinforced{dir = 4; pixel_x = 0},/obj/structure/window/reinforced{dir = 1; layer = 2.9},/obj/structure/window/reinforced{dir = 8},/obj/structure/window/reinforced,/obj/item/book/manual/research_and_development{name = "Sacred Text of the Liberator"; pixel_x = -4; pixel_y = 3},/obj/item/bedsheet/rd/royal_cape{layer = 3; pixel_x = 5; pixel_y = 9},/obj/structure/statue/gold/rd{name = "statue of the Liberator"},/turf/simulated/floor/mineral/titanium/purple,/area/shuttle/freegolem)
"aF" = (/obj/structure/extinguisher_cabinet{pixel_y = 30},/turf/simulated/floor/mineral/titanium/purple,/area/shuttle/freegolem)
"aG" = (/obj/machinery/door/airlock/shuttle,/obj/structure/fans/tiny,/obj/docking_port/stationary{area_type = /area/ruin/powered/golem_ship; dir = 8; dwidth = 8; height = 20; id = "freegolem_lavaland"; name = "Lavaland Surface"; turf_type = /turf/simulated/floor/plating/asteroid/basalt/lava_land_surface; width = 16},/obj/docking_port/mobile{dir = 8; dwidth = 8; height = 20; id = "freegolem"; name = "Free Golem Ship"; width = 16},/turf/simulated/floor/mineral/titanium/purple,/area/shuttle/freegolem)
"aH" = (/obj/structure/window/full/shuttle{icon_state = "15"},/obj/structure/grille,/turf/simulated/floor/plating,/area/shuttle/freegolem)
"aJ" = (/obj/machinery/light,/obj/structure/chair/comfy/purp{dir = 8; icon_state = "comfychair"},/turf/simulated/floor/mineral/titanium/purple,/area/shuttle/freegolem)
"aK" = (/obj/structure/extinguisher_cabinet{pixel_y = -30},/obj/machinery/light,/turf/simulated/floor/mineral/titanium/purple,/area/shuttle/freegolem)
"aL" = (/obj/structure/fans/tiny,/obj/machinery/door/airlock/shuttle,/turf/simulated/floor/mineral/titanium/purple,/area/shuttle/freegolem)
"aM" = (/obj/item/resonator/upgraded,/turf/simulated/floor/mineral/titanium/purple,/area/shuttle/freegolem)
"aN" = (/obj/machinery/autolathe,/turf/simulated/floor/mineral/titanium/purple,/area/shuttle/freegolem)
"aO" = (/obj/structure/table/wood,/obj/machinery/reagentgrinder,/turf/simulated/floor/mineral/titanium/purple,/area/shuttle/freegolem)
"aP" = (/obj/machinery/computer/shuttle/golem_ship/recall,/turf/simulated/floor/plating/asteroid/basalt/lava_land_surface,/area/ruin/powered/golem_ship)
"aQ" = (/obj/machinery/vending/coffee/free,/turf/simulated/floor/mineral/titanium/purple,/area/shuttle/freegolem)
"aR" = (/obj/machinery/vending/snack/free,/turf/simulated/floor/mineral/titanium/purple,/area/shuttle/freegolem)
"aS" = (/obj/machinery/light,/turf/simulated/floor/mineral/titanium/purple,/area/shuttle/freegolem)
"aT" = (/obj/structure/table/wood,/obj/item/storage/firstaid/brute,/obj/item/storage/firstaid/brute,/obj/item/storage/firstaid/brute,/turf/simulated/floor/mineral/titanium/purple,/area/shuttle/freegolem)
"aU" = (/obj/structure/table/wood,/obj/item/storage/firstaid/fire,/obj/item/storage/firstaid/fire,/obj/item/storage/firstaid/fire,/obj/machinery/light,/turf/simulated/floor/mineral/titanium/purple,/area/shuttle/freegolem)
"aV" = (/obj/structure/table/wood,/obj/item/storage/firstaid/adv,/obj/item/storage/firstaid/adv,/turf/simulated/floor/mineral/titanium/purple,/area/shuttle/freegolem)
"aW" = (/obj/structure/table/wood,/obj/item/disk/design_disk/golem_shell,/obj/item/areaeditor/golem,/turf/simulated/floor/mineral/titanium/purple,/area/shuttle/freegolem)
"aX" = (/obj/machinery/door/airlock/shuttle,/turf/simulated/floor/mineral/titanium/purple,/area/shuttle/freegolem)
"aY" = (/obj/machinery/light/small{dir = 1},/turf/simulated/floor/plating,/area/shuttle/freegolem)
"aZ" = (/obj/structure/reagent_dispensers/fueltank,/turf/simulated/floor/plating,/area/shuttle/freegolem)
"ba" = (/obj/structure/ore_box,/turf/simulated/floor/plating,/area/shuttle/freegolem)

(1,1,1) = {"
aaaaaaaaaaabaqaqaqaqaqaqaqaqaqacacaqaqaqaa
aaaaaaaaaaaqadadadadadadadadaeafafagahaiaa
aaaaaaaaaaaqafafajafafajafafafajafakahaiaa
aaaaabaqaqaqawawaqaqaqaqawawaqaqaqaqaqaqaa
aaaaaqalamanaoaoanaoaoanaoaoaoanaoapahaiaa
aaaaauaoaoaoaoaoaoaoasaoaoaoaoaoaoaoahaiaa
abaqaqataoaoaoaoaoayaxayaoaoaoaoaoazaqaqaA
aBaraDaoaoaoaoaoasaxaEaxasaoaoaoaoaoaFaGaA
aHavaJaoaoaoaoaoaoayaxayaoaoaoaoaoaoaKaLaA
abaqaqataoaoaoaoaoaoasaoaoaoaoaoaMaNaqaqaP
aaaaauaoaoaoaoaoaoaoaoaoaoaoaoaoaoaOahaiaa
aaaaaqaQaRaSaoaoaSaoaoaSaoaoaTaUaVaWahaiaa
aaaaabaqaqaqaXaXaqaqaqaqaXaXaqaqaqaqaqaqaa
aaaaaaaaaaaqafafaYafafaYafafafaYafaZahaiaa
aaaaaaaaaaaqbabababababababaaeafafaZahaiaa
aaaaaaaaaaabaqaqaqaqaqaqaqaqaqacacaqaqaqaa
"}
