"a" = (/turf/space,/area/space)
"b" = (/turf/simulated/wall/mineral/titanium/overspace,/area/ruin/powered)
"c" = (/obj/structure/grille,/obj/structure/window/full/reinforced,/turf/simulated/floor/plating/airless,/area/ruin/powered)
"d" = (/turf/simulated/wall/mineral/titanium/nodiagonal,/area/ruin/powered)
"e" = (/obj/structure/closet/crate/secure/loot,/turf/simulated/floor/mineral/titanium/blue/airless,/area/ruin/powered)
"f" = (/obj/structure/table,/obj/machinery/door_control{id = "mecha cargo"},/turf/simulated/floor/mineral/titanium/blue/airless,/area/ruin/powered)
"g" = (/obj/structure/table,/turf/simulated/floor/mineral/titanium/blue/airless,/area/ruin/powered)
"h" = (/obj/machinery/computer/shuttle,/turf/simulated/floor/mineral/titanium/blue/airless,/area/ruin/powered)
"i" = (/obj/effect/decal/cleanable/vomit,/turf/simulated/floor/mineral/titanium/blue/airless,/area/ruin/powered)
"j" = (/obj/effect/decal/remains/human,/turf/simulated/floor/mineral/titanium/blue/airless,/area/ruin/powered)
"k" = (/turf/simulated/floor/mineral/titanium/blue/airless,/area/ruin/powered)
"l" = (/obj/structure/chair/comfy/shuttle{dir = 1},/turf/simulated/floor/mineral/titanium/blue/airless,/area/ruin/powered)
"m" = (/obj/machinery/computer/mecha,/turf/simulated/floor/mineral/titanium/blue/airless,/area/ruin/powered)
"n" = (/obj/machinery/door/airlock/hatch,/turf/simulated/floor/mineral/titanium/airless,/area/ruin/powered)
"o" = (/turf/simulated/floor/mineral/titanium/airless,/area/ruin/powered)
"p" = (/obj/structure/mecha_wreckage/phazon,/turf/simulated/floor/mineral/titanium/yellow/airless,/area/ruin/powered)
"q" = (/turf/simulated/floor/mineral/titanium/yellow/airless,/area/ruin/powered)
"r" = (/obj/structure/mecha_wreckage/ripley/firefighter,/turf/simulated/floor/mineral/titanium/yellow/airless,/area/ruin/powered)
"s" = (/obj/structure/mecha_wreckage/ripley,/turf/simulated/floor/mineral/titanium/yellow/airless,/area/ruin/powered)
"t" = (/turf/simulated/shuttle/floor{tag = "icon-floor2"; icon_state = "floor2"},/area/ruin/powered)
"u" = (/obj/effect/decal/cleanable/blood/oil,/turf/simulated/floor/mineral/titanium/yellow/airless,/area/ruin/powered)
"v" = (/obj/effect/decal/cleanable/blood/gibs/robot/up,/turf/simulated/floor/mineral/titanium/yellow/airless,/area/ruin/powered)
"w" = (/obj/effect/decal/cleanable/blood/gibs/robot,/turf/simulated/floor/mineral/titanium/yellow/airless,/area/ruin/powered)
"x" = (/obj/structure/mecha_wreckage/durand,/turf/simulated/floor/mineral/titanium/yellow/airless,/area/ruin/powered)
"y" = (/obj/machinery/door/poddoor{id_tag = "mecha cargo"; name = "Cargo Bay Door"; tag = ""},/turf/simulated/floor/mineral/titanium/airless,/area/ruin/powered)
"z" = (/obj/item/stack/tile/mineral/titanium,/turf/simulated/floor/plating,/area/ruin/powered)
"A" = (/turf/simulated/floor/plating,/area/ruin/powered)
"B" = (/obj/item/stack/rods,/turf/simulated/floor/plating,/area/ruin/powered)
"C" = (/obj/effect/decal/cleanable/blood/gibs/robot,/turf/simulated/floor/plating,/area/ruin/powered)
"D" = (/obj/structure/lattice,/turf/space,/area/space/nearstation)
"E" = (/obj/effect/decal/cleanable/blood/gibs/robot,/obj/item/stack/tile/mineral/titanium,/turf/simulated/floor/mineral/titanium/yellow/airless,/area/ruin/powered)
"F" = (/obj/effect/landmark/damageturf,/turf/simulated/floor/plating,/area/ruin/powered)
"G" = (/obj/structure/mecha_wreckage/odysseus,/turf/simulated/floor/mineral/titanium/yellow/airless,/area/ruin/powered)
"H" = (/obj/structure/mecha_wreckage/gygax,/turf/simulated/floor/mineral/titanium/airless,/area/ruin/powered)
"I" = (/obj/structure/shuttle/engine/propulsion,/turf/simulated/floor/plating,/area/ruin/powered)
"K" = (/obj/item/stack/sheet/metal,/turf/space,/area/space/nearstation)
"M" = (/turf/unsimulated/floor/plating/airless,/area/space/nearstation)
"P" = (/obj/item/stack/rods,/turf/space,/area/space/nearstation)

(1,1,1) = {"
abcccccba
adeefghda
adijklmda
bdndddddb
doooooood
dpqqrqsqd
duqvqsqqy
dwxzqqqqy
zAqxqAqqy
DBAtCEquy
FAFzGGqqy
KDDAoAHod
aMDKBAddb
aPaaDabdb
aaaaaaIII
"}
